1111111111111
10C100000CC01
1111011111001
1P0001E000001
1111111111111
