1111111111111
110100000CC01
1000011111001
1P0011E000001
1111111111111
