111111111111111111
1P010001C00100C1C1
1101010101010101E1
110101010101010101
11010101010101C101
110101010101010101
11C101010101010101
110101010101010101
110101010101010101
11010101C10101C101
110101010101C10101
1100010001000100C1
111111111111111111
